Complement	Reverse_Complement	Reverse
VuygoheSeqaenge	egneaqeSehogyuV	ecneuqeSedocraB
CTCACAGA	AGACACTC	TCTGTGAG
CTCACTCA	ACTCACTC	TGAGTGAG
CTCACTGT	TGTCACTC	ACAGTGAG
CTCAGACA	ACAGACTC	TGTCTGAG
CTCAGAGT	TGAGACTC	ACTCTGAG
CTCAGTCT	TCTGACTC	AGACTGAG
CTCAGTGA	AGTGACTC	TCACTGAG
CTCATCAC	CACTACTC	GTGATGAG
CTCATCTG	GTCTACTC	CAGATGAG
CTCATGAG	GAGTACTC	CTCATGAG
CTCATGTC	CTGTACTC	GACATGAG
CTCTACAC	CACATCTC	GTGTAGAG
CTCTACTG	GTCATCTC	CAGTAGAG
CTCTAGAG	GAGATCTC	CTCTAGAG
CTCTAGTC	CTGATCTC	GACTAGAG
CTCTCACA	ACACTCTC	TGTGAGAG
CTAGTCCT	TCCTGATC	AGGACTAG
CTAGGTTG	GTTGGATC	CAACCTAG
CTAGGTAC	CATGGATC	GTACCTAG
CTAGGATC	CTAGGATC	GATCCTAG
CTAGGAAG	GAAGGATC	CTTCCTAG
CTAGCTTC	CTTCGATC	GAAGCTAG
CTAGCTAG	GATCGATC	CTAGCTAG
CTAGCATG	GTACGATC	CATGCTAG
CTAGCAAC	CAACGATC	GTTGCTAG
CTAGAGGA	AGGAGATC	TCCTCTAG
CTAGAGCT	TCGAGATC	AGCTCTAG
CTAGACGT	TGCAGATC	ACGTCTAG
CTAGACCA	ACCAGATC	TGGTCTAG
CTACTGGA	AGGTCATC	TCCAGTAG
CTACTGCT	TCGTCATC	AGCAGTAG
CTACTCGT	TGCTCATC	ACGAGTAG
CTACTCCA	ACCTCATC	TGGAGTAG
CTACGTTC	CTTGCATC	GAACGTAG
GGAGTGCA	ACGTGAGG	TGCACTCC
GGATATCG	GCTATAGG	CGATATCC
GGATCCAT	TACCTAGG	ATGGATCC
GGATCCGT	TGCCTAGG	ACGGATCC
CTACAGCA	ACGACATC	TGCTGTAG
CTAGTGGT	TGGTGATC	ACCACTAG
CTCACACT	TCACACTC	AGTGTGAG
CTACCAAG	GAACCATC	CTTGGTAG
CTACAGGT	TGGACATC	ACCTGTAG
CTCAACTC	CTCAACTC	GAGTTGAG
CTACCATC	CTACCATC	GATGGTAG
CTCAAGAC	CAGAACTC	GTCTTGAG
CTACCTAC	CATCCATC	GTAGGTAG
CTACCTTG	GTTCCATC	CAAGGTAG
CTACGAAC	CAAGCATC	GTTCGTAG
CTCAAGTG	GTGAACTC	CACTTGAG
CTCAACAG	GACAACTC	CTGTTGAG
CTACGATG	GTAGCATC	CATCGTAG
CTAGTGCA	ACGTGATC	TGCACTAG
CTACGTAG	GATGCATC	CTACGTAG
CTAGTCGA	AGCTGATC	TCGACTAG
